Low Income Solar House,Low Income Solar Apartment,Mid Income Solar House,Mid Income Solar Apartment,High Income Solar House,High Income Solar Apartment,Total Solar Panels
0,0,0,0,0,0,0
<<<<<<< HEAD
0,0,0,0,5,0,5
0,0,1,0,7,0,8
1,0,2,0,7,0,10
1,0,4,0,8,0,13
1,0,8,0,10,0,19
1,0,10,0,13,0,24
1,0,11,0,15,0,27
1,0,12,0,19,0,32
1,0,14,0,21,0,36
1,0,14,0,22,0,37
1,0,17,0,25,0,43
1,0,17,0,27,0,45
1,0,18,0,32,0,51
1,0,21,0,32,0,54
1,0,23,0,36,0,60
1,0,24,0,39,0,64
1,0,26,0,39,0,66
2,0,28,0,43,0,73
2,0,28,0,48,0,78
2,0,30,0,50,0,82
2,0,32,0,50,0,84
2,0,35,0,53,0,90
3,0,36,0,55,0,94
4,0,38,0,58,0,100
4,0,41,0,59,0,104
4,0,43,0,63,0,110
4,0,43,0,66,0,113
4,0,45,0,68,0,117
4,0,48,0,72,0,124
4,0,48,0,74,0,126
4,0,50,0,74,0,128
4,0,51,0,77,0,132
4,0,54,0,78,0,136
5,0,56,0,83,0,144
6,0,56,0,88,0,150
6,0,57,0,93,0,156
7,0,57,0,95,0,159
7,0,58,0,99,0,164
8,0,60,0,101,0,169
8,0,61,0,103,0,172
8,0,63,0,105,0,176
8,0,64,0,108,0,180
8,0,65,0,110,0,183
8,0,66,0,111,0,185
8,0,67,0,115,0,190
8,0,70,0,120,0,198
8,0,74,0,123,0,205
8,0,74,0,123,0,205
8,0,75,0,124,0,207
8,0,75,0,128,0,211
8,0,76,0,130,0,214
8,0,77,0,132,0,217
8,0,79,0,134,0,221
8,0,81,0,135,0,224
8,0,81,0,138,0,227
8,0,84,0,142,0,234
8,0,85,0,145,0,238
8,0,86,0,148,0,242
8,0,88,0,151,0,247
9,0,90,0,154,0,253
9,0,94,0,158,0,261
9,0,94,0,160,0,263
9,0,95,0,163,0,267
9,0,97,0,168,0,274
10,0,98,0,169,0,277
10,0,99,0,171,0,280
10,0,101,0,174,0,285
10,0,104,0,178,0,292
10,0,104,0,181,0,295
10,0,104,0,182,0,296
10,0,106,0,193,0,309
10,0,106,0,196,0,312
10,0,107,0,202,0,319
10,0,108,0,205,0,323
10,0,109,0,209,0,328
10,0,109,0,215,0,334
10,0,110,0,216,0,336
10,0,111,0,218,0,339
10,0,112,1,221,0,344
10,0,113,1,223,0,347
10,0,115,1,226,0,352
10,0,117,1,227,0,355
10,0,121,1,228,0,360
10,0,122,1,231,0,364
10,0,124,1,235,0,370
10,0,125,1,237,0,373
11,0,127,1,240,0,379
11,0,130,1,241,0,383
11,0,131,1,246,0,389
12,0,132,1,248,0,393
13,0,133,1,250,0,397
13,0,134,1,252,0,400
13,0,134,1,255,0,403
13,0,137,1,260,1,412
14,0,137,1,261,2,415
14,0,140,1,264,2,421
15,0,140,1,266,2,424
16,0,140,1,267,2,426
16,0,142,1,268,2,429
16,0,143,1,271,2,433
16,0,144,1,273,2,436
16,0,144,1,280,2,443
16,0,146,1,285,2,450
16,0,146,1,285,2,450
16,0,149,1,288,2,456
16,0,150,1,289,2,458
17,0,151,1,292,2,463
18,0,152,1,295,2,468
18,0,154,1,298,2,473
18,0,157,1,298,2,476
18,0,157,1,299,2,477
18,0,159,1,300,2,480
19,0,161,1,303,2,486
19,0,165,1,306,2,493
19,0,167,1,310,2,499
19,0,167,1,314,2,503
19,0,167,1,317,2,506
19,0,169,1,318,2,509
19,0,169,1,322,2,513
19,0,170,1,327,2,519
19,0,173,1,330,2,525
19,0,175,1,333,2,530
19,0,175,1,333,2,530
19,0,178,1,337,2,537
19,0,179,1,337,2,538
19,0,182,1,343,2,547
19,0,182,1,345,2,549
19,0,182,1,347,2,551
19,0,186,1,348,2,556
19,0,189,1,350,2,561
19,0,190,1,356,2,568
19,0,193,1,359,2,574
19,0,194,1,361,2,577
19,0,198,1,362,2,582
19,0,199,1,363,2,584
19,0,201,1,366,2,589
19,0,203,1,368,2,593
20,0,205,1,372,2,600
20,0,207,1,377,2,607
21,0,208,1,381,2,613
22,0,209,1,384,2,618
22,0,209,1,384,2,618
22,0,212,1,386,2,623
22,0,215,1,391,2,631
22,0,217,1,395,2,637
22,0,219,1,401,2,645
23,0,220,1,406,2,652
23,0,221,1,410,2,657
23,0,224,1,411,2,661
23,0,226,1,413,2,665
23,0,228,1,416,2,670
23,0,229,1,418,2,673
23,0,229,1,419,2,674
23,0,232,1,421,2,679
23,0,232,1,423,2,681
23,0,232,1,423,2,681
24,0,235,1,424,2,686
24,0,235,1,429,2,691
24,0,237,1,434,2,698
24,0,239,1,441,2,707
24,0,240,1,443,2,710
24,0,241,1,445,2,713
24,0,241,1,449,2,717
24,0,243,1,451,2,721
24,0,244,1,455,2,726
24,0,246,1,458,2,731
24,0,249,1,460,2,736
24,0,250,1,460,2,737
24,0,251,1,465,2,743
24,0,253,1,466,2,746
24,0,255,1,469,2,751
24,0,257,1,472,2,756
25,0,260,1,475,2,763
25,0,262,1,477,2,767
26,0,262,1,478,2,769
27,0,265,1,481,2,776
27,0,266,1,487,2,783
27,0,267,1,489,2,786
27,0,268,1,490,2,788
27,0,268,1,493,2,791
27,0,268,1,494,2,792
27,0,270,1,500,2,800
27,0,271,1,502,2,803
27,0,273,1,506,2,809
27,0,275,1,508,2,813
27,0,275,1,511,2,816
27,0,275,1,513,2,818
27,0,277,1,513,2,820
27,0,281,1,515,2,826
27,0,282,1,516,2,828
27,0,283,1,519,2,832
27,0,284,1,520,2,834
27,0,284,1,522,2,836
27,0,288,1,525,2,843
27,0,289,1,529,2,848
27,0,289,1,532,2,851
27,0,291,2,534,2,856
27,0,292,2,539,2,862
27,0,292,2,542,2,865
27,0,292,2,547,2,870
27,0,292,2,551,2,874
29,0,293,2,554,2,880
29,0,294,2,556,2,883
29,0,297,2,561,2,891
29,0,299,2,565,3,898
31,0,299,2,569,3,904
33,0,300,2,571,3,909
33,0,302,2,573,3,913
33,0,302,2,578,3,918
33,0,303,2,582,3,923
33,0,304,2,584,3,926
34,0,305,2,587,3,931
34,0,308,2,592,3,939
34,0,309,2,597,3,945
35,0,310,2,601,3,951
35,0,310,2,602,3,952
35,0,310,2,602,3,952
35,0,312,2,606,3,958
35,0,315,2,606,3,961
35,0,318,2,611,3,969
35,0,321,2,614,3,975
35,0,321,2,617,4,979
35,0,322,2,619,4,982
36,0,323,2,621,4,986
36,0,323,3,623,4,989
36,0,325,3,625,4,993
36,0,326,3,629,4,998
36,0,328,3,630,4,1001
36,0,331,3,632,4,1006
37,0,334,3,632,4,1010
37,0,338,3,637,4,1019
37,0,339,3,637,4,1020
37,0,342,3,638,4,1024
37,0,344,3,641,4,1029
37,0,346,3,643,4,1033
38,0,349,3,646,4,1040
38,0,352,3,647,4,1044
38,0,352,3,654,4,1051
38,0,352,3,656,4,1053
38,0,353,3,658,4,1056
39,0,355,3,659,4,1060
39,0,356,3,659,4,1061
39,0,358,3,665,4,1069
39,0,359,3,669,4,1074
39,0,360,3,671,4,1077
40,0,364,3,681,4,1092
40,0,365,3,686,4,1098
42,0,368,3,688,4,1105
42,0,372,3,690,4,1111
42,0,375,3,691,4,1115
42,0,377,3,694,4,1120
42,0,380,3,696,4,1125
42,0,381,3,699,4,1129
42,0,384,3,700,4,1133
42,0,386,3,703,4,1138
42,0,386,3,705,4,1140
43,0,386,3,708,4,1144
43,0,389,3,708,4,1147
43,0,390,3,712,4,1152
43,0,392,3,718,4,1160
43,0,392,3,721,4,1163
43,0,393,3,723,4,1166
44,0,394,3,727,4,1172
44,0,398,3,729,4,1178
44,0,400,4,731,4,1183
44,0,402,4,737,4,1191
44,0,402,4,740,4,1194
44,0,405,4,743,4,1200
44,0,407,4,743,4,1202
44,0,412,4,748,4,1212
44,0,413,4,750,4,1215
44,0,414,4,756,4,1222
44,0,418,4,761,4,1231
44,0,420,4,761,4,1233
44,0,423,4,762,4,1237
44,0,425,4,763,4,1240
44,0,428,4,764,4,1244
45,0,430,4,768,4,1251
45,0,431,4,772,4,1256
46,0,433,4,774,4,1261
46,0,434,4,775,4,1263
47,0,438,4,779,4,1272
47,0,440,4,781,4,1276
47,0,442,4,783,4,1280
47,0,443,4,785,4,1283
47,0,445,4,788,4,1288
47,0,450,4,792,4,1297
47,0,453,4,795,4,1303
47,0,456,4,799,4,1310
47,0,458,4,799,4,1312
47,0,459,4,800,4,1314
47,0,461,4,800,4,1316
47,0,464,4,805,4,1324
47,0,465,4,808,5,1329
47,0,466,4,809,5,1331
47,0,468,4,810,5,1334
47,0,469,4,811,5,1336
47,0,471,4,813,5,1340
47,0,472,4,816,5,1344
47,0,473,4,818,5,1347
47,0,474,4,826,5,1356
47,0,475,4,830,5,1361
48,0,476,4,832,5,1365
48,0,478,4,834,5,1369
49,0,480,4,837,5,1375
49,0,481,4,840,5,1379
50,0,483,4,843,5,1385
50,0,483,4,845,5,1387
50,0,484,4,846,5,1389
50,0,486,4,849,5,1394
50,0,489,4,854,5,1402
50,0,490,4,854,5,1403
50,0,493,4,854,5,1406
50,0,494,4,855,5,1408
50,0,494,4,857,5,1410
50,0,497,4,858,5,1414
50,0,500,4,859,5,1418
50,0,502,4,861,5,1422
50,0,503,4,870,5,1432
50,0,504,5,872,5,1436
50,0,504,5,873,5,1437
50,0,506,5,876,6,1443
50,0,509,5,879,6,1449
50,0,510,5,883,6,1454
50,0,511,5,885,7,1458
50,0,511,5,886,7,1459
50,0,512,5,889,7,1463
50,0,513,5,890,7,1465
50,0,514,6,893,7,1470
50,0,516,6,896,7,1475
50,0,519,6,900,7,1482
50,0,522,6,905,7,1490
50,0,522,7,908,7,1494
50,0,524,7,911,7,1499
50,0,524,8,912,7,1501
52,0,525,8,915,7,1507
52,0,527,8,916,7,1510
52,0,529,8,916,7,1512
52,0,532,8,917,7,1516
52,0,533,8,918,7,1518
52,0,535,8,919,7,1521
53,0,535,8,920,7,1523
53,0,536,8,923,7,1527
53,0,539,8,927,7,1534
53,0,541,8,928,7,1537
54,0,542,8,930,7,1541
54,0,542,8,933,7,1544
54,0,543,8,936,7,1548
54,0,544,8,939,7,1552
54,0,546,8,940,7,1555
54,0,550,8,942,7,1561
54,0,553,8,942,7,1564
54,0,554,8,944,7,1567
54,0,554,8,948,7,1571
54,0,555,8,950,7,1574
54,0,555,8,951,7,1575
54,0,556,8,954,7,1579
54,0,558,8,957,7,1584
54,0,558,8,960,7,1587
54,0,561,8,964,7,1594
54,0,562,8,965,7,1596
55,0,564,8,967,7,1601
56,0,565,8,969,7,1605
57,0,565,8,971,7,1608
57,0,567,8,971,7,1610
57,0,570,8,975,7,1617
58,0,572,8,979,7,1624
58,0,573,8,983,7,1629
59,0,574,8,984,7,1632
60,0,575,8,986,7,1636
60,0,575,8,986,7,1636
60,0,576,8,988,7,1639
60,0,577,8,989,7,1641
61,0,581,8,990,7,1647
61,0,585,8,992,7,1653
61,0,586,8,995,7,1657
61,0,587,8,998,7,1661
61,0,588,8,999,7,1663
61,0,590,8,1000,7,1666
62,0,592,8,1001,7,1670
64,0,597,8,1002,7,1678
64,0,598,8,1004,7,1681
64,0,601,8,1006,7,1686
64,0,604,8,1010,7,1693
64,0,606,8,1011,7,1696
64,0,607,8,1012,7,1698
64,0,609,8,1012,7,1700
64,0,612,8,1014,7,1705
64,0,614,8,1019,7,1712
64,0,616,8,1024,7,1719
64,0,617,8,1025,7,1721
64,0,618,9,1027,7,1725
64,0,620,9,1030,7,1730
64,0,621,9,1030,7,1731
64,0,621,9,1031,7,1732
64,0,621,9,1031,7,1732
64,0,624,9,1033,7,1737
65,0,625,9,1036,7,1742
65,0,626,9,1038,7,1745
66,0,626,9,1041,7,1749
67,0,629,9,1042,7,1754
67,0,630,9,1043,7,1756
68,0,630,9,1047,7,1761
68,0,630,9,1050,7,1764
68,0,633,9,1053,7,1770
68,0,635,9,1056,7,1775
68,0,636,9,1059,7,1779
70,0,637,9,1059,7,1782
70,0,641,9,1059,7,1786
70,0,642,9,1060,7,1788
70,0,644,9,1063,7,1793
71,0,644,9,1064,7,1795
72,0,645,9,1064,7,1797
72,0,648,9,1065,7,1801
72,0,649,9,1066,7,1803
72,0,650,9,1066,7,1804
73,0,653,9,1069,7,1811
73,0,654,9,1070,7,1813
74,0,657,9,1073,7,1820
74,0,659,9,1074,7,1823
74,0,659,9,1075,7,1824
75,0,659,9,1077,7,1827
75,0,659,9,1079,7,1829
75,0,661,9,1080,7,1832
76,0,664,9,1083,7,1839
76,0,666,9,1085,7,1843
76,0,667,9,1085,7,1844
76,0,668,9,1085,7,1845
76,0,671,9,1089,7,1852
76,0,672,9,1091,7,1855
76,0,673,9,1093,7,1858
76,0,673,9,1095,7,1860
76,0,673,9,1096,7,1861
77,0,674,9,1098,7,1865
77,0,675,9,1101,7,1869
78,0,678,9,1103,8,1876
78,0,679,9,1105,8,1879
78,0,681,9,1105,8,1881
79,0,682,9,1107,8,1885
79,0,684,9,1109,8,1889
79,1,686,9,1113,8,1896
79,1,687,9,1116,8,1900
79,1,688,9,1119,8,1904
79,1,690,9,1119,8,1906
79,1,690,9,1122,8,1909
79,1,692,9,1124,8,1913
79,1,696,9,1124,8,1917
79,1,698,9,1129,8,1924
79,1,698,9,1131,8,1926
79,1,699,9,1134,8,1930
79,1,701,9,1137,8,1935
79,1,701,9,1139,8,1937
79,1,701,9,1139,8,1937
79,1,705,9,1139,8,1941
79,1,705,9,1143,8,1945
79,1,706,9,1145,8,1948
81,1,708,9,1147,8,1954
81,1,711,9,1149,8,1959
81,1,712,9,1150,9,1962
81,1,713,9,1151,9,1964
81,1,713,9,1151,9,1964
81,1,716,9,1151,10,1968
82,1,716,9,1152,10,1970
82,1,717,9,1154,10,1973
82,1,718,9,1158,10,1978
83,1,719,9,1160,10,1982
83,1,719,9,1162,10,1984
83,1,720,9,1167,10,1990
84,1,722,9,1167,10,1993
84,1,724,9,1168,10,1996
84,1,726,9,1168,10,1998
84,1,727,9,1168,10,1999
84,1,727,9,1170,10,2001
84,1,729,9,1172,10,2005
84,1,729,9,1174,10,2007
85,1,730,9,1174,10,2009
85,1,733,9,1176,11,2015
85,1,734,9,1177,11,2017
85,1,738,9,1178,11,2022
85,1,741,9,1179,11,2026
85,1,742,9,1183,11,2031
85,1,744,9,1184,11,2034
85,1,747,9,1185,11,2038
85,1,750,9,1187,11,2043
85,1,751,9,1188,11,2045
86,1,752,9,1188,11,2047
87,1,754,9,1189,11,2051
88,1,757,9,1190,11,2056
88,1,760,9,1191,11,2060
88,1,760,9,1192,11,2061
88,1,761,9,1195,11,2065
88,1,761,9,1196,11,2066
88,1,762,9,1198,11,2069
88,1,764,9,1200,11,2073
88,1,764,9,1200,11,2073
88,1,767,9,1204,11,2080
88,1,768,9,1206,11,2083
89,1,770,9,1206,11,2086
89,1,773,10,1208,11,2092
89,1,775,10,1208,11,2094
89,1,777,10,1208,11,2096
89,1,779,10,1210,12,2101
89,1,781,10,1210,12,2103
90,1,783,10,1211,12,2107
91,1,783,10,1213,12,2110
91,1,785,10,1216,12,2115
91,1,788,10,1217,12,2119
91,1,790,10,1219,12,2123
91,1,796,10,1221,12,2131
91,1,798,10,1221,12,2133
91,1,800,10,1222,12,2136
91,1,803,10,1224,12,2141
91,1,805,10,1226,12,2145
91,1,807,10,1228,12,2149
91,1,808,10,1230,12,2152
92,1,809,10,1232,12,2156
94,1,811,10,1233,12,2161
94,1,812,10,1234,12,2163
94,1,814,10,1236,12,2167
94,1,814,10,1237,12,2168
94,1,814,10,1237,12,2168
95,1,818,10,1239,12,2175
95,1,821,10,1239,13,2179
95,1,823,11,1241,13,2184
95,1,826,11,1242,13,2188
95,1,826,11,1244,13,2190
95,1,827,11,1246,13,2193
95,1,829,11,1250,13,2199
96,1,831,11,1250,13,2202
96,1,831,11,1252,13,2204
96,1,832,11,1252,13,2205
96,1,834,11,1253,13,2208
96,1,835,11,1254,13,2210
96,1,837,11,1257,13,2215
96,1,839,11,1258,13,2218
96,1,840,11,1259,13,2220
96,1,844,11,1260,13,2225
97,1,844,11,1260,13,2226
98,1,848,11,1260,13,2231
99,1,849,11,1261,13,2234
99,1,851,11,1264,13,2239
99,1,852,11,1266,13,2242
99,1,852,11,1268,13,2244
99,1,853,11,1268,13,2245
99,1,855,12,1271,13,2251
99,1,858,12,1274,13,2257
99,1,859,12,1274,13,2258
99,1,862,12,1276,13,2263
100,1,862,12,1279,13,2267
100,1,862,12,1279,13,2267
100,1,863,12,1279,13,2268
100,1,864,12,1281,13,2271
100,1,864,12,1283,13,2273
100,1,865,12,1286,13,2277
100,1,867,12,1287,13,2280
100,1,869,12,1288,13,2283
101,1,870,12,1289,13,2286
101,1,870,12,1292,13,2289
101,1,872,12,1294,13,2293
101,1,873,12,1295,13,2295
101,1,875,12,1297,13,2299
101,1,875,12,1299,13,2301
101,1,876,13,1303,13,2307
101,1,880,13,1304,13,2312
101,1,880,13,1305,13,2313
101,1,882,13,1306,13,2316
101,1,882,13,1309,13,2319
101,1,883,13,1309,13,2320
101,1,885,13,1309,13,2322
101,1,886,13,1309,13,2323
102,1,887,13,1310,13,2326
102,1,890,13,1311,13,2330
102,1,892,13,1313,13,2334
102,1,893,13,1314,13,2336
102,1,895,13,1316,13,2340
102,1,898,13,1316,13,2343
102,1,901,13,1317,13,2347
104,1,902,13,1317,13,2350
104,1,903,13,1319,13,2353
104,1,905,13,1320,13,2356
104,1,906,13,1320,13,2357
105,1,907,13,1322,13,2361
105,1,910,13,1324,13,2366
106,1,913,13,1326,13,2372
106,1,913,13,1327,13,2373
106,1,913,13,1328,13,2374
107,1,914,13,1331,13,2379
107,1,915,14,1331,13,2381
107,1,916,14,1332,13,2383
107,1,916,14,1334,13,2385
107,1,916,14,1336,13,2387
107,1,918,14,1337,13,2390
107,1,918,14,1339,13,2392
107,1,918,14,1339,13,2392
107,1,918,14,1340,14,2394
107,1,920,14,1342,14,2398
109,1,922,14,1344,14,2404
109,1,923,14,1346,14,2407
109,1,924,14,1348,14,2410
109,1,925,14,1348,14,2411
109,1,925,14,1351,14,2414
109,1,925,14,1352,14,2415
111,1,926,14,1352,14,2418
111,1,929,14,1353,14,2422
112,1,930,14,1356,14,2427
112,1,933,14,1358,14,2432
112,1,935,14,1359,14,2435
112,1,936,14,1363,14,2440
113,1,936,14,1364,14,2442
113,1,938,14,1366,14,2446
113,1,939,14,1366,14,2447
113,1,940,14,1367,14,2449
113,1,943,14,1369,14,2454
113,1,946,15,1369,14,2458
113,1,947,15,1371,14,2461
114,1,949,15,1372,14,2465
114,1,950,15,1372,14,2466
114,1,951,15,1373,14,2468
114,1,954,15,1375,14,2473
115,1,956,15,1377,14,2478
115,1,956,15,1377,14,2478
115,1,957,15,1378,14,2480
116,1,959,15,1379,14,2484
117,1,959,15,1379,14,2485
117,1,960,15,1381,14,2488
120,1,962,15,1383,14,2495
120,1,963,15,1384,14,2497
120,1,963,15,1386,14,2499
120,1,964,15,1386,14,2500
121,1,966,15,1386,14,2503
121,1,967,15,1388,14,2506
121,1,971,15,1388,14,2510
122,1,972,15,1391,14,2515
122,1,973,15,1391,14,2516
123,1,973,15,1391,14,2517
125,1,974,15,1392,14,2521
126,1,976,15,1392,14,2524
126,1,976,15,1392,14,2524
126,1,977,15,1395,14,2528
126,1,978,15,1396,14,2530
126,1,980,15,1397,14,2533
126,1,980,15,1399,14,2535
126,1,981,15,1399,14,2536
126,1,981,15,1401,14,2538
126,1,981,15,1402,14,2539
126,1,981,15,1402,14,2539
126,1,982,15,1406,14,2544
126,1,984,15,1408,14,2548
126,1,987,15,1411,14,2554
126,1,988,15,1412,14,2556
126,1,990,15,1415,14,2561
128,1,992,15,1415,14,2565
128,1,992,15,1415,14,2565
129,1,993,15,1416,14,2568
129,1,993,15,1419,14,2571
130,1,993,15,1419,14,2572
130,1,994,15,1421,14,2575
130,1,995,15,1422,14,2577
130,1,997,16,1423,14,2581
130,1,999,16,1423,14,2583
131,1,1001,16,1424,14,2587
131,1,1002,16,1425,15,2590
131,1,1007,16,1426,15,2596
132,1,1007,16,1427,15,2598
132,1,1009,16,1428,15,2601
132,1,1010,16,1429,15,2603
132,1,1011,16,1429,15,2604
132,1,1011,16,1429,15,2604
132,1,1012,16,1432,15,2608
132,1,1015,16,1433,15,2612
132,1,1016,16,1434,15,2614
133,1,1016,16,1435,15,2616
133,1,1016,16,1436,15,2617
133,1,1017,16,1438,15,2620
133,1,1017,16,1440,15,2622
133,1,1018,16,1440,15,2623
133,1,1021,16,1440,15,2626
133,1,1023,16,1440,15,2628
133,1,1024,16,1441,15,2630
133,1,1027,16,1441,15,2633
133,1,1027,16,1442,15,2634
133,1,1028,16,1442,15,2635
134,1,1028,16,1443,15,2637
134,1,1030,16,1445,15,2641
134,1,1031,16,1447,15,2644
134,1,1031,16,1447,15,2644
134,1,1032,16,1447,15,2645
134,1,1033,16,1448,15,2647
135,1,1033,16,1450,15,2650
135,1,1035,16,1450,15,2652
135,1,1035,16,1451,15,2653
135,1,1036,16,1452,16,2656
135,1,1037,16,1452,16,2657
135,1,1039,16,1453,16,2660
135,1,1039,16,1453,16,2660
137,1,1041,16,1453,16,2664
137,1,1044,16,1454,16,2668
137,1,1045,16,1454,16,2669
138,1,1046,16,1456,16,2673
138,1,1047,16,1456,16,2674
138,1,1050,16,1456,16,2677
138,1,1050,16,1456,16,2677
139,1,1050,16,1458,16,2680
139,1,1051,16,1459,16,2682
139,1,1051,16,1459,16,2682
139,1,1053,16,1460,16,2685
139,1,1057,16,1462,16,2691
139,1,1058,16,1463,16,2693
140,1,1058,16,1464,16,2695
140,1,1059,16,1466,16,2698
140,1,1060,16,1467,16,2700
140,1,1062,16,1467,16,2702
140,1,1064,17,1467,16,2705
140,1,1064,17,1468,16,2706
141,1,1064,17,1470,16,2709
141,1,1065,17,1470,16,2710
141,1,1067,17,1470,16,2712
141,1,1068,17,1471,16,2714
141,1,1068,17,1471,16,2714
141,1,1071,17,1472,16,2718
141,1,1073,17,1473,16,2721
142,1,1075,17,1474,16,2725
142,1,1077,17,1474,16,2727
143,1,1078,17,1475,16,2730
143,1,1078,17,1475,16,2730
143,1,1080,17,1475,16,2732
143,1,1080,18,1475,16,2733
143,1,1080,18,1475,16,2733
143,1,1083,18,1475,16,2736
143,1,1084,18,1478,16,2740
143,1,1086,18,1478,16,2742
143,1,1088,18,1478,16,2744
143,1,1089,18,1480,16,2747
143,1,1090,18,1480,16,2748
143,1,1091,18,1481,16,2750
143,1,1091,18,1482,16,2751
143,1,1092,18,1483,16,2753
143,1,1094,18,1483,16,2755
143,1,1096,18,1483,16,2757
143,1,1096,18,1484,16,2758
143,1,1098,18,1484,16,2760
143,1,1098,18,1485,16,2761
143,1,1099,18,1486,16,2763
143,1,1099,18,1487,16,2764
143,1,1100,18,1487,16,2765
143,1,1104,18,1487,16,2769
143,1,1104,18,1490,16,2772
143,1,1105,18,1491,16,2774
143,1,1106,18,1491,16,2775
144,1,1109,18,1492,16,2780
144,1,1109,19,1492,16,2781
144,1,1110,19,1492,16,2782
144,1,1115,19,1493,17,2789
144,1,1116,19,1495,17,2792
145,1,1118,19,1495,17,2795
146,1,1119,19,1497,17,2799
146,1,1121,20,1497,17,2802
146,1,1122,20,1497,17,2803
146,1,1126,20,1497,17,2807
146,1,1126,20,1497,17,2807
146,1,1126,20,1497,17,2807
146,1,1128,20,1497,17,2809
146,1,1128,20,1498,17,2810
147,1,1129,20,1499,17,2813
147,1,1129,20,1499,17,2813
147,1,1130,20,1500,17,2815
148,1,1131,20,1500,17,2817
148,1,1131,20,1502,17,2819
148,1,1132,20,1503,17,2821
149,1,1132,20,1503,17,2822
149,1,1134,20,1503,17,2824
150,1,1134,20,1503,17,2825
150,1,1136,20,1503,17,2827
151,1,1137,20,1504,17,2830
151,1,1138,20,1505,17,2832
151,1,1141,21,1506,17,2837
151,1,1142,21,1507,17,2839
151,1,1143,21,1509,17,2842
151,1,1144,21,1509,17,2843
151,1,1144,21,1509,17,2843
152,1,1145,21,1509,17,2845
152,1,1147,21,1509,17,2847
152,1,1149,21,1510,17,2850
152,1,1150,21,1511,17,2852
152,1,1152,21,1512,17,2855
153,1,1153,22,1516,17,2862
153,1,1154,22,1516,17,2863
153,1,1154,22,1516,17,2863
153,1,1156,22,1517,17,2866
153,1,1157,22,1517,17,2867
153,1,1159,22,1517,17,2869
153,1,1161,22,1517,17,2871
153,1,1163,22,1518,17,2874
154,1,1164,22,1521,17,2879
154,1,1164,22,1521,17,2879
154,1,1165,22,1522,17,2881
154,1,1166,22,1523,17,2883
154,1,1169,22,1523,17,2886
154,1,1170,22,1524,17,2888
154,1,1172,22,1525,17,2891
154,1,1172,22,1526,17,2892
154,1,1173,22,1526,17,2893
154,1,1174,22,1526,17,2894
154,1,1174,22,1527,17,2895
154,1,1175,22,1527,17,2896
154,1,1176,22,1528,17,2898
154,1,1177,22,1530,17,2901
154,1,1177,22,1530,17,2901
155,1,1180,22,1530,17,2905
155,1,1182,22,1532,17,2909
155,1,1182,22,1533,17,2910
155,1,1185,22,1533,17,2913
155,1,1187,22,1533,17,2915
155,1,1189,22,1534,17,2918
155,1,1191,23,1535,17,2922
156,1,1194,23,1536,17,2927
156,1,1196,23,1536,17,2929
156,1,1196,23,1536,17,2929
157,1,1197,23,1537,17,2932
158,1,1198,23,1537,17,2934
158,1,1199,23,1537,17,2935
158,1,1199,24,1538,17,2937
158,1,1199,24,1539,17,2938
158,1,1201,24,1539,17,2940
158,1,1201,24,1540,17,2941
158,1,1203,24,1542,17,2945
158,1,1204,24,1542,17,2946
158,1,1204,24,1542,17,2946
159,1,1205,24,1542,17,2948
159,1,1206,25,1543,17,2951
159,1,1206,25,1544,17,2952
159,1,1207,25,1545,18,2955
159,1,1208,25,1545,18,2956
159,1,1209,25,1545,18,2957
159,1,1209,25,1546,18,2958
159,1,1212,25,1549,18,2964
159,1,1212,25,1549,18,2964
159,1,1213,25,1551,18,2967
159,1,1215,25,1551,18,2969
160,1,1216,25,1551,18,2971
160,1,1218,25,1552,18,2974
160,1,1220,25,1553,18,2977
160,1,1221,25,1553,18,2978
160,1,1221,25,1554,18,2979
160,1,1226,25,1555,18,2985
160,1,1229,25,1555,18,2988
160,1,1229,25,1555,18,2988
160,1,1231,25,1556,18,2991
160,1,1232,25,1557,18,2993
160,1,1232,25,1557,18,2993
161,1,1233,25,1557,18,2995
161,1,1235,26,1559,18,3000
161,1,1236,26,1559,18,3001
161,1,1236,26,1559,18,3001
161,1,1236,26,1559,18,3001
162,1,1237,26,1559,18,3003
163,1,1238,26,1559,18,3005
163,1,1240,26,1560,18,3008
163,1,1241,27,1561,18,3011
164,1,1241,27,1561,18,3012
165,1,1242,27,1562,18,3015
165,1,1242,27,1562,18,3015
165,1,1242,27,1563,18,3016
165,1,1242,27,1564,19,3018
165,1,1243,28,1564,19,3020
165,1,1244,28,1566,19,3023
165,1,1245,28,1567,19,3025
165,1,1247,28,1567,19,3027
165,1,1249,28,1567,19,3029
166,1,1250,28,1567,19,3031
166,1,1251,28,1568,19,3033
166,1,1252,28,1568,19,3034
166,1,1252,28,1570,19,3036
166,1,1253,28,1570,19,3037
166,1,1254,28,1570,19,3038
166,1,1254,28,1570,19,3038
166,1,1254,28,1573,19,3041
166,1,1255,28,1573,19,3042
166,1,1257,28,1573,19,3044
166,1,1257,28,1573,19,3044
166,1,1260,28,1573,19,3047
166,1,1262,28,1573,19,3049
166,1,1263,28,1574,19,3051
166,1,1263,28,1575,19,3052
166,1,1264,28,1575,19,3053
166,1,1265,28,1576,19,3055
166,1,1269,28,1576,19,3059
166,1,1269,28,1576,19,3059
166,1,1271,28,1576,19,3061
166,1,1271,28,1578,19,3063
166,1,1274,28,1580,19,3068
166,1,1274,28,1582,19,3070
166,1,1275,28,1582,19,3071
166,1,1275,28,1583,19,3072
166,1,1276,28,1583,19,3073
166,1,1276,28,1583,19,3073
167,1,1277,28,1583,19,3075
167,1,1278,28,1583,19,3076
167,1,1278,28,1583,19,3076
168,1,1279,28,1584,19,3079
168,1,1279,28,1585,19,3080
168,1,1280,28,1585,19,3081
168,1,1281,28,1585,19,3082
168,1,1281,28,1586,19,3083
168,1,1283,28,1588,19,3087
168,1,1284,28,1589,19,3089
168,1,1285,28,1589,19,3090
169,1,1287,28,1589,19,3093
169,1,1287,28,1589,19,3093
169,1,1287,28,1589,19,3093
169,1,1287,28,1589,19,3093
170,1,1287,28,1590,19,3095
170,1,1288,28,1590,19,3096
170,1,1290,28,1591,19,3099
171,1,1290,28,1591,19,3100
172,1,1291,28,1592,19,3103
172,1,1293,28,1593,19,3106
172,2,1295,28,1593,20,3110
172,2,1297,28,1594,20,3113
172,2,1297,28,1594,20,3113
173,2,1298,28,1594,20,3115
173,2,1299,28,1594,20,3116
173,2,1299,28,1595,20,3117
173,2,1300,28,1596,20,3119
174,2,1303,28,1596,20,3123
174,2,1306,28,1596,20,3126
174,2,1307,28,1596,20,3127
174,2,1307,28,1596,20,3127
175,2,1307,28,1596,20,3128
176,2,1310,28,1597,20,3133
176,2,1310,28,1597,20,3133
176,2,1310,28,1597,20,3133
177,2,1311,28,1597,20,3135
177,2,1311,28,1597,20,3135
177,2,1311,28,1599,20,3137
177,2,1312,28,1600,20,3139
177,2,1313,28,1600,20,3140
177,2,1315,28,1601,20,3143
177,2,1316,28,1602,20,3145
178,2,1318,28,1602,20,3148
178,2,1320,28,1602,20,3150
178,3,1321,28,1602,20,3152
179,3,1323,28,1602,20,3155
179,3,1324,28,1602,20,3156
181,3,1327,28,1602,20,3161
181,3,1327,28,1603,20,3162
181,3,1327,28,1605,20,3164
181,3,1329,28,1605,20,3166
181,3,1329,28,1605,20,3166
182,3,1329,28,1605,20,3167
184,3,1329,28,1605,20,3169
184,3,1329,28,1606,20,3170
184,3,1329,28,1607,20,3171
184,3,1329,28,1607,20,3171
184,3,1329,28,1607,20,3171
186,3,1329,28,1608,20,3174
186,3,1331,28,1608,20,3176
186,3,1332,28,1610,20,3179
186,3,1332,28,1610,20,3179
186,3,1333,28,1610,20,3180
186,3,1334,28,1610,20,3181
186,3,1335,28,1610,20,3182
186,3,1335,28,1610,20,3182
186,3,1335,28,1610,20,3182
186,3,1336,28,1610,20,3183
186,3,1337,28,1610,21,3185
186,3,1339,28,1610,21,3187
186,3,1339,28,1611,21,3188
186,3,1339,28,1612,21,3189
186,3,1339,29,1613,21,3191
186,3,1341,29,1613,21,3193
186,3,1341,29,1613,21,3193
186,3,1341,29,1614,21,3194
186,3,1341,29,1614,22,3195
186,3,1342,29,1614,23,3197
186,3,1342,29,1614,23,3197
187,3,1342,29,1614,23,3198
187,3,1343,29,1614,23,3199
187,3,1343,29,1614,23,3199
187,3,1343,29,1616,23,3201
187,3,1343,29,1618,23,3203
187,3,1343,29,1618,23,3203
187,3,1343,29,1618,23,3203
187,3,1345,29,1619,23,3206
188,3,1345,29,1619,23,3207
188,3,1346,29,1619,24,3209
189,3,1347,29,1620,24,3212
190,3,1348,29,1620,25,3215
190,3,1348,29,1620,25,3215
190,3,1348,29,1621,25,3216
190,3,1348,29,1621,25,3216
191,3,1350,29,1621,25,3219
191,3,1351,29,1621,25,3220
191,3,1351,29,1623,25,3222
191,3,1351,29,1624,25,3223
191,3,1352,29,1624,25,3224
191,3,1354,30,1624,25,3227
192,3,1354,30,1625,25,3229
192,3,1355,30,1626,25,3231
192,3,1355,30,1626,25,3231
=======
5,0,7,0,3,0,15
6,0,10,0,5,0,21
8,0,16,0,8,0,32
13,0,21,1,11,0,46
14,0,25,1,15,0,55
17,0,29,1,18,0,65
18,0,41,1,21,0,81
22,0,50,1,24,0,97
25,0,57,1,28,0,111
27,0,63,1,31,0,122
30,0,71,2,32,0,135
31,1,77,2,35,0,146
33,1,91,2,36,0,163
37,2,97,2,39,0,177
38,2,106,2,44,0,192
40,2,115,2,45,0,204
42,2,128,2,49,0,223
42,2,138,2,53,1,238
44,2,145,2,58,1,252
48,2,158,2,61,1,272
52,2,163,2,64,1,284
53,2,173,2,65,1,296
55,2,178,2,67,1,305
57,2,183,2,74,1,319
60,2,187,4,75,1,329
65,2,196,4,78,1,346
69,2,202,4,79,1,357
70,2,207,4,81,1,365
73,3,216,4,83,1,380
75,3,223,4,85,1,391
79,3,229,4,88,1,404
81,3,232,4,95,1,416
84,4,238,4,98,1,429
85,4,245,4,100,1,439
87,4,249,4,103,1,448
89,4,250,4,106,1,454
91,4,254,4,112,1,466
96,5,262,4,115,1,483
99,5,265,4,116,1,490
103,5,270,4,117,1,500
104,5,278,4,119,1,511
104,5,286,5,120,1,521
104,5,287,5,123,1,525
104,5,296,5,127,1,538
106,5,302,5,130,1,549
111,5,307,5,131,1,560
112,5,310,5,134,1,567
112,5,312,5,136,1,571
114,6,318,5,138,1,582
114,6,320,5,147,1,593
115,6,322,5,149,1,598
118,6,327,5,155,1,612
119,8,332,5,159,1,624
119,8,334,6,166,1,634
121,8,337,6,168,1,641
123,8,342,6,177,1,657
124,9,353,6,181,1,674
124,9,356,6,185,1,681
127,9,358,6,189,1,690
128,9,365,6,196,1,705
129,10,368,6,200,1,714
130,10,377,6,202,1,726
132,11,381,6,210,1,741
136,11,387,6,215,1,756
137,12,392,6,222,1,770
139,12,398,6,225,1,781
144,12,405,6,230,1,798
147,12,408,6,231,1,805
149,12,410,6,236,1,814
152,12,414,6,237,1,822
153,12,415,6,242,1,829
154,12,419,6,246,1,838
157,12,420,7,252,1,849
160,12,422,7,256,1,858
161,12,429,7,257,1,867
165,12,432,7,262,1,879
166,13,434,7,268,1,889
169,13,439,7,270,1,899
170,13,442,7,273,1,906
170,13,443,7,274,1,908
173,13,447,7,280,1,921
176,13,454,7,283,1,934
177,13,458,7,287,1,943
178,14,465,7,293,1,958
180,15,468,7,296,1,967
182,15,471,7,298,1,974
184,15,478,7,303,1,988
187,15,482,7,307,1,999
188,15,487,7,309,1,1007
190,15,494,8,313,2,1022
195,16,496,8,315,2,1032
197,16,500,8,320,2,1043
198,16,505,8,325,2,1054
201,16,509,8,329,2,1065
201,16,512,8,331,2,1070
201,16,516,8,331,2,1074
201,16,522,8,334,3,1084
203,16,526,8,338,3,1094
205,16,532,8,339,3,1103
207,16,540,8,342,3,1116
210,16,545,8,347,3,1129
212,16,551,8,348,3,1138
214,16,554,8,351,3,1146
218,17,558,8,353,3,1157
218,17,558,8,359,3,1163
219,17,560,8,362,3,1169
221,17,563,8,364,3,1176
221,17,566,8,369,3,1184
225,17,573,8,373,3,1199
229,17,583,8,374,3,1214
234,17,587,8,379,3,1228
236,17,591,8,384,3,1239
239,17,595,8,386,3,1248
242,18,599,9,390,3,1261
242,18,601,9,393,3,1266
245,18,603,9,402,3,1280
245,18,606,9,406,3,1287
246,18,610,9,409,3,1295
248,18,614,9,413,3,1305
252,19,619,9,418,3,1320
253,19,620,9,420,3,1324
254,20,623,9,426,3,1335
257,20,624,9,433,3,1346
258,20,626,10,436,3,1353
259,20,629,10,439,3,1360
260,21,634,11,440,3,1369
262,21,637,11,444,3,1378
263,22,640,11,449,3,1388
265,22,644,11,450,3,1395
267,22,648,11,456,3,1407
269,22,654,11,458,3,1417
270,23,662,12,463,3,1433
272,24,666,12,466,3,1443
275,24,667,12,466,3,1447
277,24,672,12,467,3,1455
280,24,674,14,469,3,1464
284,25,676,14,471,3,1473
286,25,677,14,474,3,1479
289,25,679,14,474,3,1484
291,26,683,14,476,3,1493
291,26,685,15,482,3,1502
291,27,689,16,485,3,1511
291,27,692,16,488,3,1517
293,27,698,16,493,3,1530
294,27,703,16,496,3,1539
296,27,705,16,500,3,1547
297,27,709,16,504,3,1556
298,27,717,16,506,3,1567
302,28,720,17,514,3,1584
303,28,723,17,515,3,1589
304,29,729,17,518,3,1600
306,29,735,17,520,3,1610
309,29,738,17,524,3,1620
310,29,741,17,526,3,1626
311,29,744,17,528,3,1632
314,29,744,17,532,3,1639
315,29,746,17,536,3,1646
316,30,749,17,539,3,1654
317,30,750,18,541,3,1659
318,30,754,18,542,3,1665
321,30,756,18,545,3,1673
325,30,756,18,552,3,1684
329,30,757,18,554,3,1691
331,30,764,18,556,4,1703
331,30,768,19,557,4,1709
334,30,769,19,561,4,1717
335,30,770,19,568,4,1726
335,31,774,19,570,4,1733
335,31,775,19,572,4,1736
336,31,776,19,575,4,1741
337,31,778,19,577,4,1746
337,31,781,19,580,5,1753
338,31,786,19,582,5,1761
340,31,789,19,588,5,1772
343,31,793,19,593,5,1784
346,32,798,19,598,5,1798
347,32,805,19,602,5,1810
349,33,807,19,605,5,1818
351,34,812,19,610,5,1831
353,34,818,20,613,5,1843
354,35,821,20,614,5,1849
356,35,824,20,618,5,1858
359,35,828,20,623,5,1870
362,35,830,20,629,5,1881
362,35,834,20,631,5,1887
366,35,837,20,635,5,1898
367,35,842,21,638,5,1908
368,35,845,22,643,5,1918
368,35,849,22,646,5,1925
368,36,853,22,649,5,1933
369,37,855,22,657,5,1945
370,37,859,22,660,5,1953
374,37,861,22,662,5,1961
374,37,862,22,663,5,1963
375,37,864,22,666,5,1969
378,37,867,22,671,5,1980
380,37,869,22,672,5,1985
384,39,872,22,679,5,2001
385,40,878,22,679,5,2009
388,41,880,22,681,5,2017
>>>>>>> c0e3b3553aec6a901b4a97ca4f1a8a1fc62bd531
